aaaa_continent = {
  13 81 212 556 762 796 998 1387 2522 2571 2575 2641 2735 2764 2890 3047 3152 3201 3443 4178 4417 4602 5006 5010 5323
  33 34 45 47 49 50 54 56 57 58 59 60 61 62 65 70 74 75 77 78 87 93 95 96 99 100 
  103 110 112 113 116 119 124 127 134 140 143 155 158 159 161 169 174 175 176 178 187 220 221 230 231 
  246 255 263 264 275 287 291 299 309 315 321 324 341 347 361 364 367 370 377 389 390 395 397 418 432 
  441 450 454 458 474 477 481 495 505 506 511 514 517 525 531 532 544 548 552 553 562 571 574 577 585 
  588 593 597 601 609 617 640 663 664 672 681 694 703 710 711 715 719 735 741 751 752 753 761 776 779 
  787 799 800 807 819 823 835 838 856 857 861 862 868 878 891 918 923 927 928 932 945 950 951 955 956 
  969 970 973 997 1003 1030 1043 1053 1054 1055 1063 1064 1071 1074 1089 1108 1112 1129 1141 1147 1156 1170 1177 1182 1188 
  1200 1201 1204 1214 1215 1218 1223 1229 1260 1261 1274 1275 1280 1287 1288 1289 1305 1334 1335 1340 1344 1364 1379 1385 1391 
  1400 1401 1404 1411 1415 1420 1430 1434 1442 1454 1455 1459 1468 1482 1489 1492 1494 1500 1502 1509 1515 1516 1517 1526 1544 
  1548 1554 1568 1569 1577 1578 1580 1584 1588 1593 1606 1611 1621 1624 1630 1631 1639 1640 1643 1645 1646 1649 1653 1659 1679 
  1686 1689 1702 1703 1706 1707 1722 1729 1738 1741 1743 1744 1745 1747 1750 1753 1759 1765 1770 1771 1772 1778 1779 1794 1796 
  1804 1806 1808 1810 1813 1816 1822 1826 1827 1829 1831 1832 1837 1841 1843 1850 1851 1856 1859 1862 1876 1881 1894 1900 1901 
  1906 1909 1911 1919 1919 1922 1930 1933 1934 1937 1938 1944 1946 1959 1961 1963 1964 1970 1974 1975 1984 2004 2005 2007 2009 
  2015 2028 2029 2032 2046 2051 2055 2057 2058 2059 2066 2073 2076 2089 2104 2108 2112 2113 2117 2126 2127 2128 2136 2137 2145 
  2146 2158 2159 2174 2177 2178 2185 2190 2199 2201 2204 2217 2222 2226 2239 2241 2242 2244 2246 2256 2260 2262 2263 2273 2274 
  2279 2285 2288 2294 2295 2298 2299 2306 2313 2314 2316 2320 2326 2327 2332 2335 2337 2349 2350 2358 2361 2364 2365 2366 2368 
  2369 2373 2378 2381 2393 2395 2400 2403 2407 2411 2412 2416 2422 2425 2428 2430 2439 2446 2448 2449 2450 2455 2457 2463 2467 
  2470 2476 2477 2481 2490 2497 2498 2499 2501 2506 2508 2509 2510 2515 2516 2523 2524 2527 2528 2532 2537 2540 2542 2544 2545 
  2546 2550 2551 2552 2554 2558 2561 2562 2566 2570 2574 2578 2579 2582 2583 2586 2588 2590 2591 2597 2598 2610 2617 2618 2619 
  2625 2627 2631 2642 2646 2647 2652 2657 2667 2672 2673 2676 2681 2682 2688 2689 2690 2691 2710 2718 2729 2731 2743 2744 2746 
  2750 2756 2757 2762 2768 2769 2778 2794 2795 2796 2797 2812 2813 2820 2821 2822 2823 2836 2838 2846 2847 2854 2858 2859 2864 
  2866 2870 2874 2886 2891 2892 2897 2903 2910 2911 2918 2919 2920 2924 2927 2933 2936 2937 2944 2951 2952 2953 2960 2961 2962 
  2965 2975 2997 3001 3005 3010 3013 3026 3044 3045 3049 3054 3059 3068 3075 3087 3088 3089 3104 3113 3117 3121 3122 3123 3140 
  3144 3151 3157 3160 3164 3173 3174 3181 3193 3195 3196 3197 3209 3215 3221 3222 3224 3241 3242 3246 3247 3251 3256 3262 3263 
  3269 3272 3273 3274 3282 3283 3287 3300 3301 3302 3306 3312 3318 3319 3321 3324 3329 3330 3331 3342 3346 3346 3349 3350 3351 
  3352 3358 3362 3365 3368 3369 3374 3383 3385 3387 3391 3402 3403 3405 3406 3411 3412 3415 3416 3420 3434 3438 3439 3453 3454 
  3455 3458 3460 3471 3481 3482 3486 3487 3492 3493 3496 3499 3503 3504 3505 3509 3513 3518 3520 3521 3527 3530 3536 3541 3542 
  3552 3560 3567 3568 3569 3574 3577 3578 3581 3582 3586 3587 3594 3595 3602 3606 3607 3625 3626 3630 3634 3635 3636 3640 3645 
  3646 3651 3664 3665 3669 3677 3678 3683 3692 3693 3698 3699 3704 3705 3709 3715 3724 3725 3730 3734 3739 3741 3746 3761 3762 
  3765 3766 3772 3774 3776 3784 3785 3790 3791 3798 3800 3801 3810 3811 3812 3817 3818 3831 3832 3836 3837 3839 3840 3841 3842 
  3846 3862 3865 3868 3869 3872 3874 3891 3892 3893 3894 3896 3901 3902 3904 3912 3914 3920 3926 3929 3930 3937 3938 3939 3941 
  3946 3955 3958 3959 3963 3965 3971 3972 3973 3974 3979 3986 3987 3991 3997 3998 3999 4003 4004 4006 4007 4020 4023 4024 4025 
  4026 4030 4034 4035 4036 4039 4042 4050 4053 4068 4069 4072 4081 4082 4094 4097 4100 4103 4111 4115 4116 4117 4124 4127 4130 
  4131 4134 4141 4145 4148 4149 4153 4156 4163 4164 4165 4168 4171 4173 4179 4180 4184 4185 4186 4187 4200 4201 4204 4205 4210 
  4212 4218 4225 4233 4236 4239 4246 4248 4253 4254 4255 4260 4269 4272 4288 4293 4299 4300 4303 4307 4308 4308 4311 4316 4319 
  4320 4324 4325 4330 4333 4341 4355 4365 4368 4381 4382 4385 4389 4390 4391 4394 4395 4403 4407 4415 4416 4421 4435 4456 4460 
  4481 4482 4490 4492 4495 4498 4514 4521 4545 4551 4552 4556 4561 4563 4580 4580 4581 4604 4608 4609 4614 4619 4626 4627 4628 
  4632 4636 4641 4657 4657 4658 4670 4671 4678 4683 4686 4687 4690 4694 4695 4699 4700 4703 4718 4733 4734 4747 4748 4749 4753 
  4761 4765 4766 4781 4783 4801 4815 4818 4820 4832 4836 4855 4869 4870 4894 4926 4942 4948 4953 4956 4965 4968 4970 4975 
}
aaab_continent = {
  1 2 3 4 5 6 7 8 12 14 18 21 22 23 24 26 28 29 31 35 36 37 38 39 41 
  43 44 46 48 51 55 63 64 66 68 69 71 72 79 80 82 85 86 88 89 90 91 92 94 97 
  98 101 104 105 106 108 109 111 114 115 117 118 120 121 122 123 125 128 129 130 132 135 137 138 144 
  145 146 148 149 150 151 152 153 154 156 160 162 163 165 166 167 168 170 171 172 177 179 180 181 182 
  183 185 188 189 190 192 194 197 198 200 201 202 203 206 207 208 209 210 211 213 214 215 216 217 218 
  219 222 223 224 225 226 227 228 232 233 234 235 236 237 238 239 240 241 242 243 244 245 247 248 249 
  250 251 252 253 254 257 258 259 260 265 266 267 268 269 270 271 272 273 274 276 277 278 279 280 281 
  282 283 284 285 288 289 292 293 294 296 297 298 300 301 303 307 310 311 312 313 314 316 317 318 319 
  320 322 323 325 326 328 329 330 331 332 333 334 335 336 337 338 339 340 342 343 344 348 349 350 351 
  352 353 354 356 357 358 359 362 363 365 368 369 371 372 373 374 375 376 378 379 380 382 384 385 386 
  387 388 391 392 393 394 396 398 399 400 401 402 403 404 405 406 407 408 409 411 412 413 414 415 416 
  417 419 420 421 422 423 424 426 427 428 429 431 433 434 435 436 437 438 439 440 443 444 445 446 447 
  448 449 451 452 453 455 456 457 459 460 461 462 463 464 465 466 467 468 469 470 471 473 475 476 478 
  482 483 484 485 486 487 488 489 490 491 492 493 494 496 497 498 499 500 501 502 503 504 507 508 509 
  510 512 515 516 518 520 521 522 523 526 527 528 529 533 534 535 536 537 538 539 540 541 542 543 545 
  546 549 550 551 554 555 558 559 563 564 565 566 567 572 573 575 578 579 580 581 582 583 586 589 590 
  591 592 594 595 596 598 599 600 602 603 605 606 607 608 610 611 612 613 615 616 618 619 622 623 624 
  627 628 630 631 634 635 636 639 641 642 643 644 646 647 648 650 651 652 653 654 656 657 659 662 665 
  666 669 670 673 674 675 676 677 679 680 682 684 685 688 690 691 692 696 696 697 700 701 704 705 706 
  707 708 709 712 716 717 718 720 721 722 723 724 725 726 728 733 736 737 738 739 742 743 747 748 754 
  755 757 758 763 766 766 767 768 769 771 772 773 774 775 780 782 783 784 785 786 788 789 790 790 792 
  793 794 795 797 801 802 805 806 808 809 810 812 813 814 820 824 825 831 832 833 834 836 839 840 841 
  843 844 845 846 847 848 850 851 853 854 855 863 864 865 866 867 869 870 871 872 873 875 876 877 879 
  880 881 882 883 887 888 889 892 893 894 895 896 897 898 899 902 903 904 905 906 907 908 909 910 911 
  914 915 917 919 921 922 924 925 926 929 933 934 936 937 938 939 943 944 946 947 952 953 954 957 958 
  959 960 962 963 964 967 968 971 974 975 976 977 979 981 982 983 984 985 986 987 988 990 991 992 993 
  994 995 999 1000 1001 1004 1005 1008 1011 1013 1014 1017 1020 1021 1023 1024 1025 1027 1028 1031 1032 1033 1034 1035 1036 
  1037 1038 1039 1044 1045 1046 1047 1050 1056 1057 1058 1059 1060 1061 1062 1065 1066 1067 1075 1076 1077 1078 1080 1081 1084 
  1085 1086 1090 1091 1092 1093 1096 1097 1098 1102 1103 1104 1105 1109 1110 1111 1113 1114 1115 1118 1120 1122 1123 1126 1127 
  1128 1130 1131 1132 1133 1135 1136 1137 1138 1142 1143 1144 1145 1148 1150 1151 1152 1154 1155 1157 1158 1159 1164 1165 1166 
  1167 1168 1171 1172 1173 1174 1175 1180 1183 1184 1185 1186 1189 1190 1191 1192 1193 1194 1197 1198 1199 1202 1205 1206 1207 
  1211 1212 1213 1216 1219 1220 1221 1222 1224 1225 1226 1230 1231 1232 1234 1235 1236 1237 1238 1239 1240 1242 1244 1245 1246 
  1249 1250 1251 1253 1254 1258 1262 1263 1264 1265 1266 1267 1268 1271 1272 1276 1277 1278 1279 1281 1282 1284 1285 1286 1290 
  1291 1294 1295 1296 1299 1302 1303 1306 1307 1308 1309 1310 1311 1312 1314 1315 1316 1317 1320 1321 1323 1324 1325 1326 1327 
  1328 1331 1336 1337 1341 1342 1345 1346 1347 1348 1350 1351 1352 1353 1355 1356 1358 1359 1360 1361 1365 1366 1367 1368 1370 
  1372 1373 1382 1383 1386 1392 1393 1394 1395 1396 1402 1405 1406 1409 1412 1413 1414 1416 1417 1419 1421 1423 1426 1427 1428 
  1431 1432 1433 1435 1436 1437 1439 1440 1443 1446 1449 1456 1457 1460 1461 1463 1466 1469 1470 1471 1472 1473 1476 1477 1478 
  1480 1481 1483 1484 1487 1490 1491 1493 1495 1496 1497 1498 1501 1503 1507 1510 1511 1512 1518 1519 1520 1523 1524 1527 1528 
  1534 1535 1536 1537 1538 1539 1542 1543 1545 1546 1549 1550 1551 1552 1553 1556 1557 1559 1563 1570 1571 1579 1581 1582 1585 
  1589 1591 1592 1594 1595 1596 1597 1601 1602 1607 1608 1612 1618 1622 1625 1626 1627 1633 1634 1636 1644 1647 1650 1656 1657 
  1662 1663 1665 1669 1672 1676 1687 1690 1697 1699 1700 1701 1705 1708 1714 1717 1726 1727 1730 1734 1736 1739 1742 1746 1748 
  1756 1760 1763 1766 1767 1773 1776 1777 1780 1783 1785 1788 1797 1798 1803 1809 1811 1812 1817 1818 1823 1830 1833 1834 1835 
  1838 1839 1840 1844 1845 1846 1860 1863 1864 1866 1868 1872 1874 1877 1878 1882 1883 1884 1887 1889 1895 1902 1904 1907 1912 
  1913 1915 1923 1926 1927 1928 1931 1936 1947 1948 1950 1951 1952 1957 1968 1971 1972 1977 1978 1980 1981 1985 1989 1990 1992 
  1993 1994 1996 1997 1999 2001 2006 2008 2010 2011 2012 2016 2019 2020 2021 2023 2030 2039 2042 2044 2047 2048 2052 2060 2063 
  2064 2067 2070 2071 2077 2080 2083 2084 2085 2100 2101 2105 2106 2107 2109 2110 2114 2118 2120 2121 2122 2124 2130 2131 2132 
  2138 2142 2147 2148 2154 2160 2164 2165 2170 2179 2180 2181 2183 2186 2191 2202 2205 2212 2213 2214 2223 2231 2234 2235 2236 
  2240 2247 2249 2251 2264 2267 2271 2272 2276 2287 2289 2307 2308 2312 2317 2336 2342 2344 2345 2346 2353 2371 2374 2383 2396 
  2401 2405 2418 2426 2429 2431 2441 2452 2483 5652 
}
aaac_continent = {
  1374 1380 1424 1441 1499 1504 1558 1564 1572 1586 1600 1616 1617 1619 1623 1632 1660 1664 1666 1673 1696 1709 1710 1711 1720 1740 
  1757 1758 1774 1784 1800 1805 1807 1819 1824 1849 1852 1853 1861 1865 1879 1880 1885 1890 1896 1897 1903 1905 1910 1914 1916 
  1917 1924 1932 1935 1939 1942 1953 1954 1955 1956 1965 1969 1973 1982 1986 1991 1995 1998 2013 2024 2025 2026 2033 2034 2035 
  2043 2053 2056 2065 2074 2086 2090 2103 2115 2119 2125 2133 2141 2143 2152 2155 2156 2166 2175 2192 2197 2208 2215 2218 2219 
  2224 2237 2252 2253 2254 2257 2265 2268 2275 2278 2280 2305 2309 2321 2339 2340 2343 2347 2352 2379 2384 2388 2394 2399 2402 
  2404 2406 2408 2442 2443 2447 2453 2456 2459 2460 2461 2480 2484 2487 2491 2496 2503 2504 2518 2519 2521 2533 2534 2535 2538 
  2556 2557 2560 2565 2569 2573 2577 2580 2585 2595 2606 2609 2612 2621 2628 2633 2637 2638 2639 2654 2655 2660 2661 2664 2684 
  2685 2692 2698 2699 2713 2721 2723 2741 2742 2748 2749 2754 2763 2776 2780 2785 2791 2800 2804 2808 2816 2817 2826 2837 2852 
  2857 2862 2863 2868 2869 2872 2879 2884 2887 2909 2914 2915 2926 2929 2930 2931 2935 2940 2949 2950 2966 2968 2973 2981 2984 
  2985 2986 2991 2992 2993 2995 3011 3021 3022 3028 3029 3030 3040 3041 3042 3053 3062 3072 3074 3079 3082 3083 3085 3093 3096 
  3097 3103 3105 3106 3107 3109 3119 3127 3130 3132 3135 3137 3143 3147 3148 3158 3159 3162 3176 3187 3188 3189 3194 3199 3207 
  3210 3226 3227 3231 3237 3245 3249 3250 3254 3259 3260 3268 3288 3291 3294 3297 3298 3299 3311 3313 3314 3333 3334 3347 3348 
  3354 3355 3356 3361 3366 3367 3372 3396 3401 3423 3432 3442 3444 3450 3451 3456 3457 3461 3477 3485 3511 3523 3535 3539 3540 
  3557 3612 3613 3622 3650 3721 3731 3732 3733 3737 3754 3783 3804 3815 3825 3835 3859 3883 3906 3919 3927 3961 3970 3978 4002 
  4012 4040 4049 4060 4079 4101 4106 4110 4161 4176 4202 4217 4221 
}
aaad_continent = {
  9 10 11 15 16 17 19 20 25 27 30 32 40 42 52 53 67 73 76 83 84 102 107 126 131 
  133 136 139 141 142 147 157 164 173 184 186 191 193 195 196 199 204 205 229 256 261 262 286 290 295 
  302 304 305 306 308 327 345 346 355 360 366 381 383 410 425 430 442 472 479 480 513 519 524 530 547 
  557 560 561 568 569 570 576 584 587 604 614 620 621 625 626 629 632 633 637 638 645 649 655 658 660 
  661 667 668 671 678 683 686 687 689 693 695 698 699 702 713 714 727 729 730 731 732 734 740 744 745 
  746 749 750 756 759 760 764 765 770 777 778 781 791 798 803 804 811 815 816 817 818 821 822 826 827 
  828 829 830 842 849 852 858 859 860 874 884 885 886 890 900 901 912 913 916 920 930 931 935 940 941 
  942 948 949 961 965 966 972 978 980 989 996 1002 1006 1007 1009 1010 1012 1015 1016 1018 1019 1022 1026 1029 1040 
  1041 1042 1048 1049 1051 1052 1068 1069 1070 1072 1073 1079 1082 1083 1087 1088 1094 1095 1099 1100 1101 1106 1107 1116 1117 
  1119 1121 1124 1125 1134 1139 1140 1146 1149 1153 1160 1161 1162 1163 1169 1176 1178 1179 1181 1187 1195 1196 1203 1208 1209 
  1210 1217 1227 1228 1233 1241 1243 1247 1248 1252 1255 1256 1257 1259 1269 1270 1273 1283 1292 1293 1297 1298 1300 1301 1304 
  1313 1318 1319 1322 1329 1330 1332 1333 1338 1339 1343 1349 1354 1357 1362 1363 1369 1371 1375 1376 1377 1378 1381 1384 1388 
  1389 1390 1397 1398 1399 1403 1407 1408 1410 1418 1425 1429 1438 1444 1445 1447 1448 1450 1451 1452 1453 1458 1462 1464 1465 
  1467 1474 1475 1479 1485 1486 1488 1505 1506 1508 1513 1514 1521 1522 1525 1529 1530 1531 1532 1533 1540 1541 1547 1555 1560 
  1561 1562 1565 1566 1567 1573 1574 1575 1576 1583 1587 1590 1598 1599 1603 1604 1605 1609 1610 1613 1614 1615 1620 1628 1629 
  1635 1637 1638 1641 1642 1648 1651 1652 1654 1655 1658 1661 1667 1668 1670 1671 1674 1675 1677 1678 1680 1681 1682 1683 1684 
  1685 1688 1691 1692 1693 1694 1695 1698 1704 1712 1713 1715 1716 1718 1719 1721 1723 1724 1725 1728 1731 1732 1733 1735 1737 
  1749 1751 1752 1754 1755 1761 1762 1764 1768 1769 1775 1781 1782 1786 1787 1789 1790 1791 1792 1793 1795 1799 1801 1802 1814 
  1815 1820 1821 1825 1828 1836 1842 1847 1848 1854 1855 1857 1858 1867 1869 1870 1871 1873 1875 1886 1888 1891 1892 1893 1898 
  1899 1908 1918 1920 1921 1925 1929 1940 1941 1943 1945 1949 1958 1960 1962 1966 1967 1976 1979 1983 1987 1988 2000 2002 2003 
  2014 2017 2018 2022 2027 2031 2036 2037 2038 2040 2041 2045 2049 2050 2054 2061 2062 2068 2069 2072 2075 2078 2079 2081 2082 
  2087 2088 2091 2092 2093 2094 2095 2096 2097 2098 2099 2102 2111 2116 2123 2129 2134 2135 2139 2140 2144 2149 2150 2151 2153 
  2157 2161 2162 2163 2167 2168 2169 2171 2172 2173 2176 2182 2184 2187 2188 2189 2193 2194 2195 2196 2198 2200 2203 2206 2207 
  2209 2210 2211 2216 2220 2221 2225 2227 2228 2229 2230 2232 2233 2238 2243 2245 2248 2250 2255 2258 2259 2261 2266 2269 2270 
  2277 2281 2282 2283 2284 2286 2290 2291 2292 2293 2297 2300 2301 2302 2303 2304 2310 2315 2318 2319 2322 2323 2325 2330 2331 
  2333 2341 2348 2354 2355 2356 2357 2359 2360 2362 2363 2372 2377 2380 2385 2386 2389 2391 2392 2397 2409 2410 2414 2415 2419 
  2427 2432 2434 2435 2437 2438 2444 2445 2454 2462 2464 2465 2466 2469 2473 2474 2475 2478 2479 2485 2488 2489 2492 2493 2494 
  2505 2511 2514 2525 2529 2530 2536 2539 2543 2549 2553 2576 2581 2594 2596 2603 2608 2611 2613 2614 2615 2616 2620 2622 2623 
  2624 2626 2630 2636 2640 2644 2645 2649 2650 2651 2656 2662 2663 2665 2665 2666 2670 2671 2678 2679 2680 2686 2687 2693 2694 
  2700 2701 2702 2703 2704 2705 2706 2707 2709 2717 2722 2724 2727 2728 2730 2734 2736 2737 2755 2758 2759 2760 2761 2767 2770 
  2771 2774 2775 2777 2781 2786 2787 2792 2793 2801 2802 2809 2810 2811 2818 2819 2827 2831 2832 2833 2834 2835 2849 2853 2855 
  2865 2873 2880 2885 2889 2894 2895 2896 2902 2906 2916 2917 2932 2956 2959 2964 2974 2987 2988 2994 2996 3002 3004 3009 3012 
  3015 3018 3019 3025 3031 3035 3043 3048 3057 3058 3063 3077 3080 3081 3084 3086 3094 3098 3100 3101 3101 3110 3111 3112 3120 
  3131 3133 3138 3139 3141 3149 3150 3156 3163 3166 3167 3168 3171 3172 3177 3183 3185 3200 3208 3211 3212 3217 3218 3219 3228 
  3232 3233 3234 3238 3239 3240 3255 3261 3265 3279 3280 3281 3296 3308 3322 3323 3326 3335 3336 3345 3357 3371 3373 3380 3393 
  3394 3397 3399 3408 3409 3410 3414 3424 3433 3445 3446 3452 3491 3502 3508 3512 3545 3558 3573 3575 3580 3590 3628 3643 3660 
  3689 3690 3708 3728 3745 3779 5577 
}
aaae_continent = {
  3425 3427 3428 3430 3447 3462 3463 3473 3480 3498 3517 3524 3525 3526 3546 3550 3559 3585 3605 3614 3620 3623 3624 3627 3629 3633 
  3644 3657 3661 3674 3675 3676 3711 3717 3722 3723 3729 3738 3749 3750 3755 3760 3764 3769 3796 3797 3805 3806 3816 3823 3826 
  3827 3845 3852 3853 3860 3861 3866 3867 3873 3879 3884 3890 3907 3924 3925 3936 3944 3945 3950 3957 3962 3982 3990 4013 4014 
  4015 4019 4022 4029 4041 4046 4054 4065 4067 4076 4080 4085 4089 4096 4102 4108 4109 4113 4123 4126 4133 4139 4144 4147 4162 
  4167 4177 4183 4193 4194 4197 4208 4209 4216 4222 4223 4224 4230 4231 4232 4235 4241 4242 4245 4251 4252 4261 4262 4263 4264 
  4267 4268 4271 4276 4277 4278 4282 4285 4286 4287 4292 4296 4306 4310 4312 4313 4314 4315 4317 4318 4327 4328 4329 4332 4339 
  4340 4343 4345 4346 4353 4354 4360 4363 4364 4370 4372 4374 4375 4379 4380 4384 4386 4387 4388 4397 4398 4399 4405 4410 4413 
  4414 4420 4427 4432 4437 4443 4450 4457 4458 4459 4463 4465 4466 4473 4479 4480 4485 4486 4489 4494 4497 4502 4503 4509 4517 
  4518 4519 4520 4527 4535 4539 4542 4543 4544 4548 4550 4557 4569 4570 4571 4574 4575 4578 4579 4585 4594 4596 4603 4605 4607 
  4617 4618 4630 4631 4635 4643 4646 4650 4652 4662 4667 4675 4676 4677 4685 4692 4698 4709 4710 4711 4712 4716 4726 4732 4739 
  4740 4743 4744 4752 4759 4760 4764 4776 4777 4778 4779 4780 4787 4789 4799 4800 4807 4810 4813 4814 4817 4822 4823 4828 4831 
  4833 4835 4841 4847 4848 4851 4853 4854 4866 4867 4868 4876 4877 4880 4881 4882 4884 4889 4893 4899 4905 4909 4910 4914 4915 
  4916 4917 4921 4928 4929 4937 4938 4940 4941 4946 4947 4952 4955 4958 4963 4964 4967 4978 4979 4980 4981 4985 4986 4994 4999 
  5005 5008 5013 5015 5016 5017 5019 5020 5021 5022 5023 5028 5032 5033 5034 5041 5045 5049 5051 5052 5053 5056 5057 5059 5072 
  5075 5079 5080 5082 5086 5088 5089 5090 5100 5102 5103 5104 5106 5107 5108 5109 5113 5116 5118 5119 5126 5127 5128 5131 5132 
  5133 5134 5152 5156 5162 5163 5166 5170 5171 5176 5181 5188 5189 5193 5200 5201 5204 5206 5207 5213 5214 5221 5224 5229 5230 
  5231 5232 5235 5238 5239 5240 5243 5244 5247 5253 5254 5255 5256 5257 5258 5261 5263 5265 5266 5267 5271 5272 5273 5275 5278 
  5279 5280 5283 5287 5288 5290 5291 5292 5293 5297 5300 5302 5306 5308 5310 5311 5313 5314 5318 5319 5321 5322 5324 5325 5327 
  5331 5332 5335 5337 5338 5339 5343 5344 5345 5348 5349 5350 5351 5353 5354 5355 5356 5358 5360 5364 5366 5367 5368 5369 5370 
  5372 5373 5374 5375 5376 5377 5378 5379 5380 5381 5382 5383 5384 5385 5386 5387 5388 5389 5391 5392 5393 5394 5395 5396 5397 
  5398 5399 5400 5401 5402 5403 5404 5405 5406 5407 5408 5409 5410 5411 5412 5413 5414 5415 5416 5417 5418 5419 5420 5421 5422 
  5423 5424 5425 5426 5427 5428 5429 5430 5431 5432 5433 5434 5435 5436 5437 5438 5439 5440 5441 5442 5443 5444 5445 5446 5447 
  5448 5449 5450 5451 5452 5453 5454 5455 5456 5457 5457 5458 5459 5460 5461 5462 5463 5464 5465 5466 5467 5468 5469 5470 5471 
  5472 5473 5474 5475 5476 5477 5478 5478 5479 5480 5481 5482 5483 5484 5485 5486 5487 5488 5489 
}
aaaf_continent = {
  2296 2311 2324 2328 2329 2334 2338 2351 2367 2370 2375 2376 2382 2387 2390 2398 2413 2417 2420 2421 2423 2424 2433 2436 2440 2451 
  2458 2468 2471 2472 2482 2486 2495 2500 2502 2507 2512 2513 2517 2520 2526 2531 2541 2547 2548 2555 2559 2563 2564 2567 2568 
  2572 2584 2587 2589 2592 2593 2599 2600 2601 2602 2604 2605 2607 2629 2632 2634 2635 2643 2648 2653 2658 2659 2668 2669 2674 
  2675 2677 2683 2695 2696 2697 2708 2711 2712 2714 2715 2716 2719 2720 2725 2726 2732 2733 2738 2739 2740 2745 2747 2751 2752 
  2753 2765 2766 2772 2773 2779 2782 2783 2784 2788 2789 2790 2798 2799 2803 2805 2806 2807 2814 2815 2824 2825 2828 2829 2830 
  2839 2840 2842 2843 2844 2845 2848 2850 2851 2856 2860 2861 2867 2871 2875 2876 2877 2878 2881 2882 2883 2888 2893 2898 2899 
  2900 2901 2904 2905 2907 2908 2912 2913 2921 2922 2923 2925 2928 2934 2938 2939 2941 2942 2943 2945 2946 2947 2948 2954 2955 
  2957 2958 2963 2967 2969 2970 2971 2972 2976 2977 2978 2979 2980 2982 2983 2989 2990 2998 2999 3000 3003 3006 3007 3008 3014 
  3016 3017 3020 3023 3024 3027 3032 3033 3034 3036 3037 3038 3039 3046 3050 3051 3052 3055 3056 3060 3061 3064 3065 3066 3067 
  3069 3070 3071 3073 3076 3078 3090 3091 3092 3095 3099 3102 3108 3114 3115 3116 3118 3124 3125 3126 3128 3129 3134 3136 3142 
  3145 3146 3153 3154 3155 3161 3165 3169 3170 3175 3178 3179 3180 3182 3184 3186 3190 3191 3192 3198 3202 3203 3204 3205 3206 
  3213 3214 3216 3220 3223 3225 3229 3230 3235 3236 3243 3244 3248 3252 3253 3257 3258 3264 3266 3267 3270 3271 3275 3276 3277 
  3278 3284 3285 3286 3289 3290 3292 3293 3295 3303 3304 3305 3307 3309 3310 3315 3316 3317 3320 3325 3327 3328 3332 3337 3338 
  3339 3340 3341 3343 3344 3353 3359 3360 3363 3364 3370 3375 3376 3377 3378 3379 3381 3382 3384 3386 3388 3389 3390 3392 3395 
  3398 3400 3404 3407 3413 3417 3418 3419 3421 3422 3426 3429 3431 3435 3436 3437 3440 3441 3448 3449 3459 3464 3465 3466 3467 
  3468 3469 3470 3472 3474 3475 3476 3478 3479 3483 3484 3488 3489 3490 3494 3495 3497 3500 3501 3506 3507 3510 3514 3515 3516 
  3519 3522 3528 3529 3531 3532 3533 3534 3537 3538 3543 3544 3547 3548 3549 3551 3553 3554 3555 3556 3561 3562 3563 3564 3565 
  3566 3570 3571 3572 3576 3579 3583 3584 3588 3589 3591 3592 3593 3596 3597 3598 3599 3600 3601 3603 3604 3608 3609 3610 3611 
  3615 3616 3617 3618 3619 3621 3631 3632 3637 3638 3639 3641 3642 3647 3648 3649 3652 3653 3654 3655 3656 3658 3659 3662 3663 
  3666 3667 3668 3670 3671 3672 3673 3679 3680 3681 3682 3684 3685 3686 3687 3688 3691 3694 3695 3696 3697 3700 3701 3702 3703 
  3706 3707 3710 3712 3713 3714 3716 3718 3719 3720 3726 3727 3735 3736 3740 3742 3743 3744 3747 3748 3751 3752 3753 3756 3757 
  3758 3759 3763 3767 3768 3770 3771 3773 3775 3777 3778 3780 3781 3782 3786 3787 3788 3789 3792 3793 3794 3795 3799 3802 3803 
  3807 3808 3809 3813 3814 3819 3820 3821 3822 3824 3828 3829 3830 3833 3834 3838 3843 3844 3847 3848 3849 3850 3851 3854 3855 
  3856 3857 3858 3863 3864 3870 3871 3875 3876 3877 3878 3880 3881 3882 3885 3886 3887 3888 3889 3895 3898 3899 3900 3903 3905 
  3908 3909 3910 3911 3913 3915 3916 3917 3918 3921 3922 3923 3928 3931 3932 3933 3934 3935 3940 3942 3943 3947 3948 3949 3951 
  3952 3953 3954 3956 3960 3964 3966 3967 3968 3969 3975 3976 3977 3980 3981 3983 3984 3985 3988 3989 3992 3993 3994 3995 3996 
  4000 4001 4005 4008 4009 4010 4011 4016 4017 4018 4021 4027 4028 4031 4032 4033 4037 4038 4043 4044 4045 4047 4048 4051 4052 
  4055 4056 4057 4058 4059 4061 4062 4063 4064 4066 4070 4071 4073 4074 4075 4077 4078 4083 4084 4086 4087 4088 4090 4091 4092 
  4093 4095 4098 4099 4104 4105 4107 4112 4114 4118 4119 4120 4121 4122 4125 4128 4129 4132 4135 4136 4137 4138 4140 4142 4143 
  4146 4150 4151 4152 4154 4155 4157 4158 4159 4160 4166 4169 4170 4172 4174 4175 4181 4182 4188 4189 4190 4191 4192 4195 4196 
  4198 4199 4203 4206 4207 4211 4213 4214 4215 4219 4220 4226 4227 4228 4229 4234 4237 4238 4240 4243 4244 4247 4249 4250 4256 
  4257 4258 4259 4265 4266 4270 4273 4274 4275 4279 4280 4281 4283 4284 4289 4290 4291 4294 4295 4297 4298 4301 4302 4304 4305 
  4309 4321 4322 4323 4326 4331 4334 4335 4336 4337 4338 4342 4344 4347 4348 4349 4350 4351 4352 4356 4357 4358 4359 4361 4362 
  4366 4367 4369 4371 4373 4376 4377 4378 4383 4392 4393 4396 4400 4401 4402 4404 4406 4408 4409 4411 4412 4418 4419 4422 4423 
  4424 4425 4426 4428 4429 4430 4431 4433 4434 4436 4438 4439 4440 4441 4442 4444 4445 4446 4447 4448 4449 4451 4452 4453 4454 
  4455 4461 4462 4464 4467 4468 4469 4470 4471 4472 4474 4475 4476 4477 4478 4483 4484 4487 4488 4491 4493 4496 4499 4500 4501 
  4504 4505 4506 4507 4508 4510 4511 4512 4513 4515 4516 4522 4523 4524 4525 4526 4528 4529 4530 4531 4532 4533 4534 4536 4537 
  4538 4540 4541 4546 4547 4549 4553 4554 4555 4558 4559 4560 4562 4564 4565 4566 4567 4568 4572 4573 4576 4577 4582 4583 4584 
  4586 4587 4587 4588 4589 4590 4591 4592 4593 4595 4597 4598 4599 4600 4601 4606 4610 4611 4612 4613 4615 4616 4620 4621 4622 
  4623 4624 4625 4629 4633 4634 4637 4638 4639 4640 4642 4644 4645 4647 4648 4649 4651 4653 4654 4655 4656 4659 4660 4661 4663 
  4664 4665 4666 4668 4669 4672 4673 4674 4679 4680 4681 4682 4684 4688 4689 4691 4693 4696 4697 4701 4702 4704 4705 4706 4707 
  4708 4713 4714 4715 4717 4719 4720 4721 4722 4723 4724 4725 4727 4728 4729 4730 4731 4735 4736 4737 4738 4741 4742 4745 4746 
  4750 4751 4754 4755 4756 4757 4758 4762 4763 4767 4768 4769 4770 4771 4772 4773 4774 4775 4782 4784 4785 4786 4788 4790 4791 
  4792 4793 4794 4795 4796 4797 4798 4802 4803 4804 4805 4806 4808 4809 4811 4812 4816 4819 4821 4824 4825 4826 4827 4829 4830 
  4834 4837 4838 4839 4840 4842 4843 4844 4845 4846 4849 4850 4852 4856 4857 4858 4859 4860 4861 4862 4863 4864 4865 4871 4872 
  4873 4874 4875 4878 4879 4883 4885 4886 4887 4888 4890 4891 4892 4895 4896 4897 4898 4900 4901 4902 4903 4904 4906 4907 4908 
  4911 4912 4913 4918 4919 4920 4922 4923 4924 4925 4927 4930 4931 4932 4933 4934 4935 4936 4939 4943 4944 4945 4949 4950 4951 
  4954 4957 4959 4960 4961 4962 4966 4969 4971 4972 4973 4974 4976 4977 4982 4983 4984 4987 4988 4989 4990 4991 4992 4993 4995 
  4996 4997 4998 5000 5001 5002 5003 5004 5007 5009 5011 5012 5014 5018 5024 5025 5026 5027 5029 5030 5031 5035 5036 5037 5038 
  5039 5040 5042 5043 5044 5046 5047 5048 5050 5054 5055 5058 5060 5061 5062 5063 5064 5065 5066 5067 5068 5069 5070 5071 5073 
  5074 5076 5077 5078 5081 5083 5084 5085 5087 5091 5092 5093 5094 5095 5096 5097 5098 5099 5101 5105 5110 5111 5112 5114 5115 
  5117 5120 5121 5122 5123 5124 5125 5129 5130 5135 5136 5137 5138 5139 5140 5141 5142 5143 5144 5145 5146 5147 5148 5149 5150 
  5151 5153 5154 5155 5157 5158 5159 5160 5161 5164 5165 5167 5168 5169 5172 5173 5174 5175 5177 5178 5179 5180 5182 5183 5184 
  5185 5186 5187 5190 5191 5192 5194 5195 5196 5197 5198 5199 5202 5203 5205 5208 5209 5210 5211 5212 5215 5216 5217 5218 5219 
  5222 5223 5225 5226 5227 5228 5233 5234 5236 5237 5241 5242 5245 5246 5248 5249 5250 5251 5252 5259 5260 5262 5264 5268 5269 
  5270 5274 5276 5277 5281 5282 5284 5285 5286 5289 5294 5295 5296 5298 5299 5301 5303 5304 5305 5307 5309 5312 5315 5316 5317 
  5320 5326 5328 5329 5330 5333 5334 5336 5340 5341 5342 5346 5347 5352 5357 5359 5361 5362 5363 5365 5371 5390 
}
europe = {
}asia = {
}africa = {
}north_america = {
}south_america = {
}oceania = {
}island_check_provinces = {
}new_world = {
}
